%S%%%%%%%%%%
%          %
%  %%%%%%%%%
%        % %
%  %%%%%%% %
%  %     % %
%  %  %  % %
%  %       G
%  % %%%%% %
%        % %
%  %%%%    %
%%%%%%%%%%%%