%S%%%%%%%%%%
%      %   %
%  %%%%%%% %
%          %
%%%%%% %%% %
%  %     % %
%  % %% %% %
%          %
%  %%%%%%% %
%      %%% %
%  %%%%    %
%%%%%%%%G%%%