%S%%%%%%%%%%
%      %   %
%  %%%%%%% %
%          %
%  %%% %%% %
%  %     % %
%  %  %  % %
%  %       %
%  % %%%%% %
%        % %
%  %%%%    %
%%%%%%%%G%%%